###############################################
#...........................................###
#.#####.############################.######.###
S.#####.#........###...........#####.######.###
#######.#.######.###.#########.#####.######.###
#######.#.#......###.#########.#####.######.###
#######...#.########.#########.#####.######.###
#######.###......###.###############.######.###
#######.########.###.########........######.###
#######.#####################.#############.###
###.....#####################.#############.###
#######.########..................######....###
#######.#########################......F.######
#######....########.........###########.#######
#######.###########.#######.###########.#######
#######.................###.............#######
###########################.###################
###########################.###################
###############################################